{
  "name": "Unicorne",
  "vendorProductId": 1114862947,
  "macros": [
    "{+KC_LCTL}b{-KC_LCTL}",
    "",
    "",
    "",
    "",
    "",
    "",
    "",
    "",
    "",
    "",
    "",
    "",
    "",
    "",
    ""
  ],
  "layers": [
    [
      "KC_ESC",
      "KC_Q",
      "KC_W",
      "KC_E",
      "KC_R",
      "KC_T",
      "KC_TAB",
      "KC_A",
      "KC_S",
      "KC_D",
      "KC_F",
      "KC_G",
      "KC_LCTL",
      "MT(MOD_LALT,KC_Z)",
      "KC_X",
      "KC_C",
      "KC_V",
      "KC_B",
      "KC_NO",
      "KC_NO",
      "KC_NO",
      "KC_LGUI",
      "MO(1)",
      "KC_LSFT",
      "KC_BSPC",
      "KC_P",
      "KC_O",
      "KC_I",
      "KC_U",
      "KC_Y",
      "KC_ENT",
      "KC_SCLN",
      "KC_L",
      "KC_K",
      "KC_J",
      "KC_H",
      "KC_RSFT",
      "KC_SLSH",
      "KC_DOT",
      "KC_COMM",
      "KC_M",
      "KC_N",
      "KC_NO",
      "KC_NO",
      "KC_NO",
      "MO(3)",
      "MO(2)",
      "KC_SPC"
    ],
    [
      "KC_GRV",
      "S(KC_1)",
      "S(KC_2)",
      "S(KC_3)",
      "S(KC_4)",
      "S(KC_5)",
      "KC_TRNS",
      "S(KC_1)",
      "S(KC_2)",
      "S(KC_3)",
      "KC_MINS",
      "S(KC_EQL)",
      "KC_TRNS",
      "KC_LALT",
      "KC_TRNS",
      "S(KC_LBRC)",
      "S(KC_RBRC)",
      "KC_BSLS",
      "KC_NO",
      "KC_NO",
      "KC_NO",
      "KC_TRNS",
      "KC_TRNS",
      "KC_TRNS",
      "KC_TRNS",
      "S(KC_0)",
      "S(KC_9)",
      "KC_9",
      "KC_8",
      "KC_7",
      "KC_TRNS",
      "KC_QUOT",
      "S(KC_BSLS)",
      "KC_6",
      "KC_5",
      "KC_4",
      "KC_TRNS",
      "KC_PEQL",
      "S(KC_COMM)",
      "KC_3",
      "KC_2",
      "KC_1",
      "KC_NO",
      "KC_NO",
      "KC_NO",
      "KC_PDOT",
      "KC_P0",
      "KC_TRNS"
    ],
    [
      "S(KC_GRV)",
      "S(KC_1)",
      "S(KC_2)",
      "S(KC_3)",
      "S(KC_4)",
      "S(KC_5)",
      "QK_CLEAR_EEPROM",
      "KC_TRNS",
      "KC_TRNS",
      "KC_TRNS",
      "S(KC_MINS)",
      "KC_TRNS",
      "KC_TRNS",
      "KC_LALT",
      "KC_TRNS",
      "KC_TRNS",
      "KC_TRNS",
      "KC_TRNS",
      "KC_NO",
      "KC_NO",
      "KC_NO",
      "KC_TRNS",
      "KC_TRNS",
      "KC_TRNS",
      "KC_DEL",
      "KC_RBRC",
      "KC_LBRC",
      "S(KC_8)",
      "S(KC_7)",
      "S(KC_6)",
      "KC_HOME",
      "S(KC_QUOT)",
      "KC_RGHT",
      "KC_UP",
      "KC_DOWN",
      "KC_LEFT",
      "KC_END",
      "KC_TRNS",
      "KC_TRNS",
      "KC_TRNS",
      "KC_TRNS",
      "KC_TRNS",
      "KC_NO",
      "KC_NO",
      "KC_NO",
      "KC_TRNS",
      "KC_TRNS",
      "KC_TRNS"
    ],
    [
      "KC_TRNS",
      "KC_TRNS",
      "KC_TRNS",
      "KC_TRNS",
      "KC_TRNS",
      "KC_TRNS",
      "KC_TRNS",
      "KC_TRNS",
      "KC_TRNS",
      "KC_TRNS",
      "KC_TRNS",
      "KC_TRNS",
      "KC_TRNS",
      "KC_TRNS",
      "KC_TRNS",
      "KC_TRNS",
      "KC_TRNS",
      "KC_TRNS",
      "KC_TRNS",
      "KC_TRNS",
      "KC_TRNS",
      "KC_TRNS",
      "KC_TRNS",
      "KC_TRNS",
      "KC_MUTE",
      "KC_MNXT",
      "KC_MPRV",
      "KC_VOLU",
      "KC_VOLD",
      "KC_MPLY",
      "KC_TRNS",
      "KC_TRNS",
      "KC_TRNS",
      "KC_TRNS",
      "KC_TRNS",
      "KC_TRNS",
      "KC_TRNS",
      "KC_TRNS",
      "KC_TRNS",
      "KC_TRNS",
      "KC_TRNS",
      "MACRO(0)",
      "KC_TRNS",
      "KC_TRNS",
      "KC_TRNS",
      "KC_TRNS",
      "KC_TRNS",
      "KC_TRNS"
    ],
    [
      "KC_TRNS",
      "KC_TRNS",
      "KC_TRNS",
      "KC_TRNS",
      "KC_TRNS",
      "KC_TRNS",
      "KC_TRNS",
      "KC_TRNS",
      "KC_TRNS",
      "KC_TRNS",
      "KC_TRNS",
      "KC_TRNS",
      "KC_TRNS",
      "KC_TRNS",
      "KC_TRNS",
      "KC_TRNS",
      "KC_TRNS",
      "KC_TRNS",
      "KC_TRNS",
      "KC_TRNS",
      "KC_TRNS",
      "KC_TRNS",
      "KC_TRNS",
      "KC_TRNS",
      "KC_TRNS",
      "KC_TRNS",
      "KC_TRNS",
      "KC_TRNS",
      "KC_TRNS",
      "KC_TRNS",
      "KC_TRNS",
      "KC_TRNS",
      "KC_TRNS",
      "KC_TRNS",
      "KC_TRNS",
      "KC_TRNS",
      "KC_TRNS",
      "KC_TRNS",
      "KC_TRNS",
      "KC_TRNS",
      "KC_TRNS",
      "KC_TRNS",
      "KC_TRNS",
      "KC_TRNS",
      "KC_TRNS",
      "KC_TRNS",
      "KC_TRNS",
      "KC_TRNS"
    ],
    [
      "KC_TRNS",
      "KC_TRNS",
      "KC_TRNS",
      "KC_TRNS",
      "KC_TRNS",
      "KC_TRNS",
      "KC_TRNS",
      "KC_TRNS",
      "KC_TRNS",
      "KC_TRNS",
      "KC_TRNS",
      "KC_TRNS",
      "KC_TRNS",
      "KC_TRNS",
      "KC_TRNS",
      "KC_TRNS",
      "KC_TRNS",
      "KC_TRNS",
      "KC_TRNS",
      "KC_TRNS",
      "KC_TRNS",
      "KC_TRNS",
      "KC_TRNS",
      "KC_TRNS",
      "KC_TRNS",
      "KC_TRNS",
      "KC_TRNS",
      "KC_TRNS",
      "KC_TRNS",
      "KC_TRNS",
      "KC_TRNS",
      "KC_TRNS",
      "KC_TRNS",
      "KC_TRNS",
      "KC_TRNS",
      "KC_TRNS",
      "KC_TRNS",
      "KC_TRNS",
      "KC_TRNS",
      "KC_TRNS",
      "KC_TRNS",
      "KC_TRNS",
      "KC_TRNS",
      "KC_TRNS",
      "KC_TRNS",
      "KC_TRNS",
      "KC_TRNS",
      "KC_TRNS"
    ]
  ],
  "encoders": []
}